"filename", "language", "GLSL", "C++", "comment", "blank", "total"
"c:\Users\gabri\OneDrive\Desktop\MySpecialEngine\MySpecialEngine\Scripts\AObjectDraw.cpp", "C++", 0, -555, -15, -71, -641
"c:\Users\gabri\OneDrive\Desktop\MySpecialEngine\MySpecialEngine\Scripts\AObjectDraw.h", "C++", 0, -63, -6, -12, -81
"c:\Users\gabri\OneDrive\Desktop\MySpecialEngine\MySpecialEngine\Scripts\ApplicationMain.cpp", "C++", 0, -225, -11, -30, -266
"c:\Users\gabri\OneDrive\Desktop\MySpecialEngine\MySpecialEngine\Scripts\ApplicationMain.h", "C++", 0, -20, 0, -5, -25
"c:\Users\gabri\OneDrive\Desktop\MySpecialEngine\MySpecialEngine\Scripts\Button.h", "C++", 0, -23, 0, -5, -28
"c:\Users\gabri\OneDrive\Desktop\MySpecialEngine\MySpecialEngine\Scripts\Camera.h", "C++", 0, -83, 0, -3, -86
"c:\Users\gabri\OneDrive\Desktop\MySpecialEngine\MySpecialEngine\Scripts\Constants.h", "C++", 0, -14, -3, -3, -20
"c:\Users\gabri\OneDrive\Desktop\MySpecialEngine\MySpecialEngine\Scripts\DrawingPad.cpp", "C++", 0, -82, -12, -9, -103
"c:\Users\gabri\OneDrive\Desktop\MySpecialEngine\MySpecialEngine\Scripts\DrawingPad.h", "C++", 0, -25, -3, -6, -34
"c:\Users\gabri\OneDrive\Desktop\MySpecialEngine\MySpecialEngine\Scripts\EngineBase.h", "C++", 0, -16, 0, -1, -17
"c:\Users\gabri\OneDrive\Desktop\MySpecialEngine\MySpecialEngine\Scripts\GUIText.cpp", "C++", 0, -243, -10, -50, -303
"c:\Users\gabri\OneDrive\Desktop\MySpecialEngine\MySpecialEngine\Scripts\GUIText.h", "C++", 0, -56, 0, -12, -68
"c:\Users\gabri\OneDrive\Desktop\MySpecialEngine\MySpecialEngine\Scripts\GlStuff.h", "C++", 0, -11, -3, -2, -16
"c:\Users\gabri\OneDrive\Desktop\MySpecialEngine\MySpecialEngine\Scripts\GlobalVars.h", "C++", 0, -32, -3, -1, -36
"c:\Users\gabri\OneDrive\Desktop\MySpecialEngine\MySpecialEngine\Scripts\IntializeShaders.h", "C++", 0, -143, -3, -12, -158
"c:\Users\gabri\OneDrive\Desktop\MySpecialEngine\MySpecialEngine\Scripts\KeyPresses.cpp", "C++", 0, -58, -3, -7, -68
"c:\Users\gabri\OneDrive\Desktop\MySpecialEngine\MySpecialEngine\Scripts\KeyPresses.h", "C++", 0, -17, -3, -4, -24
"c:\Users\gabri\OneDrive\Desktop\MySpecialEngine\MySpecialEngine\Scripts\Lighting.h", "C++", 0, -37, 0, -6, -43
"c:\Users\gabri\OneDrive\Desktop\MySpecialEngine\MySpecialEngine\Scripts\Line.h", "C++", 0, -105, 0, -6, -111
"c:\Users\gabri\OneDrive\Desktop\MySpecialEngine\MySpecialEngine\Scripts\List.h", "C++", 0, -114, 0, -2, -116
"c:\Users\gabri\OneDrive\Desktop\MySpecialEngine\MySpecialEngine\Scripts\MathFunctions.cpp", "C++", 0, -32, 0, -3, -35
"c:\Users\gabri\OneDrive\Desktop\MySpecialEngine\MySpecialEngine\Scripts\MathFunctions.h", "C++", 0, -13, 0, -2, -15
"c:\Users\gabri\OneDrive\Desktop\MySpecialEngine\MySpecialEngine\Scripts\Mouse.h", "C++", 0, -16, 0, -4, -20
"c:\Users\gabri\OneDrive\Desktop\MySpecialEngine\MySpecialEngine\Scripts\ObjectClasses.h", "C++", 0, -214, -5, -16, -235
"c:\Users\gabri\OneDrive\Desktop\MySpecialEngine\MySpecialEngine\Scripts\Raycasting.h", "C++", 0, -53, 0, -19, -72
"c:\Users\gabri\OneDrive\Desktop\MySpecialEngine\MySpecialEngine\Scripts\VAOCreate.h", "C++", 0, -310, -6, -11, -327
"c:\Users\gabri\OneDrive\Desktop\MySpecialEngine\MySpecialEngine\Scripts\Vector.h", "C++", 0, -154, 0, -11, -165
"c:\Users\gabri\OneDrive\Desktop\MySpecialEngine\MySpecialEngine\Shaders\BasicFrag.frag", "GLSL", 12, 0, 0, 5, 17
"c:\Users\gabri\OneDrive\Desktop\MySpecialEngine\MySpecialEngine\Shaders\BasicVert.vert", "GLSL", 16, 0, 0, 4, 20
"c:\Users\gabri\OneDrive\Desktop\MySpecialEngine\MySpecialEngine\Shaders\NoTextureFrag.frag", "GLSL", 8, 0, 0, 3, 11
"c:\Users\gabri\OneDrive\Desktop\MySpecialEngine\MySpecialEngine\Shaders\NoTextureVert.vert", "GLSL", 13, 0, 0, 4, 17
"c:\Users\gabri\OneDrive\Desktop\MySpecialEngine\MySpecialEngine\Shaders\SMappingBasicFrag.frag", "GLSL", 47, 0, 0, 11, 58
"c:\Users\gabri\OneDrive\Desktop\MySpecialEngine\MySpecialEngine\Shaders\SMappingBasicVert.vert", "GLSL", 21, 0, 0, 5, 26
"c:\Users\gabri\OneDrive\Desktop\MySpecialEngine\MySpecialEngine\Shaders\SMappingDepthTextureFrag.frag", "GLSL", 4, 0, 0, 2, 6
"c:\Users\gabri\OneDrive\Desktop\MySpecialEngine\MySpecialEngine\Shaders\SMappingDepthTextureVert.vert", "GLSL", 9, 0, 0, 2, 11
"c:\Users\gabri\OneDrive\Desktop\MySpecialEngine\MySpecialEngine\Shaders\SMappingNoTextureFrag.frag", "GLSL", 43, 0, 0, 11, 54
"c:\Users\gabri\OneDrive\Desktop\MySpecialEngine\MySpecialEngine\Shaders\SMappingNoTextureVert.vert", "GLSL", 18, 0, 0, 5, 23
"c:\Users\gabri\OneDrive\Desktop\MySpecialEngine\MySpecialEngine\Shaders\SShadowingBasicFrag.frag", "GLSL", 12, 0, 0, 5, 17
"c:\Users\gabri\OneDrive\Desktop\MySpecialEngine\MySpecialEngine\Shaders\SShadowingBasicVert.vert", "GLSL", 16, 0, 0, 4, 20
"c:\Users\gabri\OneDrive\Desktop\MySpecialEngine\MySpecialEngine\Shaders\SShadowingNoTextureFrag.frag", "GLSL", 9, 0, 0, 3, 12
"c:\Users\gabri\OneDrive\Desktop\MySpecialEngine\MySpecialEngine\Shaders\SShadowingNoTextureGeom.geom", "GLSL", 37, 0, 21, 7, 65
"c:\Users\gabri\OneDrive\Desktop\MySpecialEngine\MySpecialEngine\Shaders\SShadowingNoTextureVert.vert", "GLSL", 10, 0, 0, 3, 13
"Total", "-", 275, -2714, -65, -239, -2743