"filename", "language", "GLSL", "C++", "comment", "blank", "total"
"c:\Users\gabri\OneDrive\Desktop\Coding\MySpecialEngine\CPPEngine\Scripts\AObjectDraw.cpp", "C++", 0, -260, -26, -44, -330
"c:\Users\gabri\OneDrive\Desktop\Coding\MySpecialEngine\CPPEngine\Scripts\AObjectDraw.h", "C++", 0, -60, -6, -14, -80
"c:\Users\gabri\OneDrive\Desktop\Coding\MySpecialEngine\CPPEngine\Scripts\ApplicationMain.cpp", "C++", 0, -261, -9, -32, -302
"c:\Users\gabri\OneDrive\Desktop\Coding\MySpecialEngine\CPPEngine\Scripts\ApplicationMain.h", "C++", 0, -20, 0, -5, -25
"c:\Users\gabri\OneDrive\Desktop\Coding\MySpecialEngine\CPPEngine\Scripts\Camera.cpp", "C++", 0, -28, -8, -2, -38
"c:\Users\gabri\OneDrive\Desktop\Coding\MySpecialEngine\CPPEngine\Scripts\Camera.h", "C++", 0, -133, 0, -22, -155
"c:\Users\gabri\OneDrive\Desktop\Coding\MySpecialEngine\CPPEngine\Scripts\Constants.h", "C++", 0, -20, -3, -3, -26
"c:\Users\gabri\OneDrive\Desktop\Coding\MySpecialEngine\CPPEngine\Scripts\DrawingPad.cpp", "C++", 0, -83, -4, -7, -94
"c:\Users\gabri\OneDrive\Desktop\Coding\MySpecialEngine\CPPEngine\Scripts\DrawingPad.h", "C++", 0, -24, -3, -6, -33
"c:\Users\gabri\OneDrive\Desktop\Coding\MySpecialEngine\CPPEngine\Scripts\EngineBase.h", "C++", 0, -16, 0, -1, -17
"c:\Users\gabri\OneDrive\Desktop\Coding\MySpecialEngine\CPPEngine\Scripts\GUIText.cpp", "C++", 0, -272, -1, -71, -344
"c:\Users\gabri\OneDrive\Desktop\Coding\MySpecialEngine\CPPEngine\Scripts\GUIText.h", "C++", 0, -39, 0, -9, -48
"c:\Users\gabri\OneDrive\Desktop\Coding\MySpecialEngine\CPPEngine\Scripts\GlStuff.h", "C++", 0, -10, -3, -2, -15
"c:\Users\gabri\OneDrive\Desktop\Coding\MySpecialEngine\CPPEngine\Scripts\GlobalVars.h", "C++", 0, -29, -3, -1, -33
"c:\Users\gabri\OneDrive\Desktop\Coding\MySpecialEngine\CPPEngine\Scripts\IntializeShaders.h", "C++", 0, -220, -3, -22, -245
"c:\Users\gabri\OneDrive\Desktop\Coding\MySpecialEngine\CPPEngine\Scripts\KeyPresses.cpp", "C++", 0, -58, -3, -7, -68
"c:\Users\gabri\OneDrive\Desktop\Coding\MySpecialEngine\CPPEngine\Scripts\KeyPresses.h", "C++", 0, -17, -3, -4, -24
"c:\Users\gabri\OneDrive\Desktop\Coding\MySpecialEngine\CPPEngine\Scripts\List.h", "C++", 0, -150, 0, -4, -154
"c:\Users\gabri\OneDrive\Desktop\Coding\MySpecialEngine\CPPEngine\Scripts\MathFunctions.cpp", "C++", 0, -42, 0, -9, -51
"c:\Users\gabri\OneDrive\Desktop\Coding\MySpecialEngine\CPPEngine\Scripts\MathFunctions.h", "C++", 0, -15, 0, -2, -17
"c:\Users\gabri\OneDrive\Desktop\Coding\MySpecialEngine\CPPEngine\Scripts\ModelLoading.cpp", "C++", 0, -310, -9, -47, -366
"c:\Users\gabri\OneDrive\Desktop\Coding\MySpecialEngine\CPPEngine\Scripts\ModelLoading.h", "C++", 0, -74, 0, -11, -85
"c:\Users\gabri\OneDrive\Desktop\Coding\MySpecialEngine\CPPEngine\Scripts\Mouse.h", "C++", 0, -16, 0, -4, -20
"c:\Users\gabri\OneDrive\Desktop\Coding\MySpecialEngine\CPPEngine\Scripts\ObjectClasses.h", "C++", 0, -291, 0, -35, -326
"c:\Users\gabri\OneDrive\Desktop\Coding\MySpecialEngine\CPPEngine\Scripts\Vector.h", "C++", 0, -197, 0, -12, -209
"c:\Users\gabri\OneDrive\Desktop\Coding\MySpecialEngine\CPPEngine\Shaders\BasicFrag.frag", "GLSL", 8, 0, 0, 5, 13
"c:\Users\gabri\OneDrive\Desktop\Coding\MySpecialEngine\CPPEngine\Shaders\BasicNoTextureFrag.frag", "GLSL", 7, 0, 0, 3, 10
"c:\Users\gabri\OneDrive\Desktop\Coding\MySpecialEngine\CPPEngine\Shaders\BasicNoTextureVert.vert", "GLSL", 12, 0, 0, 4, 16
"c:\Users\gabri\OneDrive\Desktop\Coding\MySpecialEngine\CPPEngine\Shaders\BasicVert.vert", "GLSL", 12, 0, 0, 4, 16
"c:\Users\gabri\OneDrive\Desktop\Coding\MySpecialEngine\CPPEngine\Shaders\FractalFrag.frag", "GLSL", 29, 0, 0, 11, 40
"c:\Users\gabri\OneDrive\Desktop\Coding\MySpecialEngine\CPPEngine\Shaders\FractalVert.vert", "GLSL", 6, 0, 0, 1, 7
"c:\Users\gabri\OneDrive\Desktop\Coding\MySpecialEngine\CPPEngine\Shaders\SMappingBasicFrag.frag", "GLSL", 47, 0, 0, 11, 58
"c:\Users\gabri\OneDrive\Desktop\Coding\MySpecialEngine\CPPEngine\Shaders\SMappingBasicVert.vert", "GLSL", 21, 0, 0, 5, 26
"c:\Users\gabri\OneDrive\Desktop\Coding\MySpecialEngine\CPPEngine\Shaders\SMappingDepthTextureFrag.frag", "GLSL", 4, 0, 0, 2, 6
"c:\Users\gabri\OneDrive\Desktop\Coding\MySpecialEngine\CPPEngine\Shaders\SMappingDepthTextureVert.vert", "GLSL", 9, 0, 0, 2, 11
"c:\Users\gabri\OneDrive\Desktop\Coding\MySpecialEngine\CPPEngine\Shaders\SMappingNoTextureFrag.frag", "GLSL", 43, 0, 0, 11, 54
"c:\Users\gabri\OneDrive\Desktop\Coding\MySpecialEngine\CPPEngine\Shaders\SMappingNoTextureVert.vert", "GLSL", 18, 0, 0, 5, 23
"c:\Users\gabri\OneDrive\Desktop\Coding\MySpecialEngine\CPPEngine\Shaders\TextFrag.frag", "GLSL", 8, 0, 0, 5, 13
"c:\Users\gabri\OneDrive\Desktop\Coding\MySpecialEngine\CPPEngine\Shaders\TextSetupFrag.frag", "GLSL", 8, 0, 0, 5, 13
"c:\Users\gabri\OneDrive\Desktop\Coding\MySpecialEngine\CPPEngine\Shaders\TextSetupVert.vert", "GLSL", 9, 0, 0, 3, 12
"c:\Users\gabri\OneDrive\Desktop\Coding\MySpecialEngine\CPPEngine\Shaders\TextVert.vert", "GLSL", 9, 0, 0, 2, 11
"c:\Users\gabri\OneDrive\Desktop\Coding\MySpecialEngine\CPPEngine\Shaders\WhiteSpaceFrag.frag", "GLSL", 6, 0, 0, 2, 8
"c:\Users\gabri\OneDrive\Desktop\Coding\MySpecialEngine\CPPEngine\Shaders\WhiteSpaceVert.vert", "GLSL", 9, 0, 0, 2, 11
"Total", "-", 265, -2645, -84, -293, -2757