"filename", "language", "GLSL", "C++", "comment", "blank", "total"
"c:\Users\gabri\OneDrive\Desktop\MySpecialEngine\MySpecialEngine\Scripts\AObjectDraw.cpp", "C++", 0, -516, -102, -68, -686
"c:\Users\gabri\OneDrive\Desktop\MySpecialEngine\MySpecialEngine\Scripts\AObjectDraw.h", "C++", 0, -65, -7, -12, -84
"c:\Users\gabri\OneDrive\Desktop\MySpecialEngine\MySpecialEngine\Scripts\ApplicationMain.cpp", "C++", 0, -265, -11, -33, -309
"c:\Users\gabri\OneDrive\Desktop\MySpecialEngine\MySpecialEngine\Scripts\ApplicationMain.h", "C++", 0, -20, 0, -5, -25
"c:\Users\gabri\OneDrive\Desktop\MySpecialEngine\MySpecialEngine\Scripts\Button.h", "C++", 0, -23, 0, -5, -28
"c:\Users\gabri\OneDrive\Desktop\MySpecialEngine\MySpecialEngine\Scripts\Camera.h", "C++", 0, -83, 0, -3, -86
"c:\Users\gabri\OneDrive\Desktop\MySpecialEngine\MySpecialEngine\Scripts\Constants.h", "C++", 0, -15, -3, -3, -21
"c:\Users\gabri\OneDrive\Desktop\MySpecialEngine\MySpecialEngine\Scripts\DrawingPad.cpp", "C++", 0, -78, -16, -9, -103
"c:\Users\gabri\OneDrive\Desktop\MySpecialEngine\MySpecialEngine\Scripts\DrawingPad.h", "C++", 0, -25, -3, -6, -34
"c:\Users\gabri\OneDrive\Desktop\MySpecialEngine\MySpecialEngine\Scripts\EngineBase.h", "C++", 0, -16, 0, -1, -17
"c:\Users\gabri\OneDrive\Desktop\MySpecialEngine\MySpecialEngine\Scripts\GUIText.cpp", "C++", 0, -243, -10, -50, -303
"c:\Users\gabri\OneDrive\Desktop\MySpecialEngine\MySpecialEngine\Scripts\GUIText.h", "C++", 0, -56, 0, -12, -68
"c:\Users\gabri\OneDrive\Desktop\MySpecialEngine\MySpecialEngine\Scripts\GlStuff.h", "C++", 0, -11, -3, -2, -16
"c:\Users\gabri\OneDrive\Desktop\MySpecialEngine\MySpecialEngine\Scripts\GlobalVars.h", "C++", 0, -32, -3, -1, -36
"c:\Users\gabri\OneDrive\Desktop\MySpecialEngine\MySpecialEngine\Scripts\IntializeShaders.h", "C++", 0, -219, -3, -22, -244
"c:\Users\gabri\OneDrive\Desktop\MySpecialEngine\MySpecialEngine\Scripts\KeyPresses.cpp", "C++", 0, -58, -3, -7, -68
"c:\Users\gabri\OneDrive\Desktop\MySpecialEngine\MySpecialEngine\Scripts\KeyPresses.h", "C++", 0, -17, -3, -4, -24
"c:\Users\gabri\OneDrive\Desktop\MySpecialEngine\MySpecialEngine\Scripts\LightingMain.cpp", "C++", 0, -379, -24, -92, -495
"c:\Users\gabri\OneDrive\Desktop\MySpecialEngine\MySpecialEngine\Scripts\LightingMain.h", "C++", 0, -27, 0, -9, -36
"c:\Users\gabri\OneDrive\Desktop\MySpecialEngine\MySpecialEngine\Scripts\Line.h", "C++", 0, -105, 0, -6, -111
"c:\Users\gabri\OneDrive\Desktop\MySpecialEngine\MySpecialEngine\Scripts\List.h", "C++", 0, -167, 0, -4, -171
"c:\Users\gabri\OneDrive\Desktop\MySpecialEngine\MySpecialEngine\Scripts\MathFunctions.cpp", "C++", 0, -44, 0, -9, -53
"c:\Users\gabri\OneDrive\Desktop\MySpecialEngine\MySpecialEngine\Scripts\MathFunctions.h", "C++", 0, -15, 0, -2, -17
"c:\Users\gabri\OneDrive\Desktop\MySpecialEngine\MySpecialEngine\Scripts\Mouse.h", "C++", 0, -16, 0, -4, -20
"c:\Users\gabri\OneDrive\Desktop\MySpecialEngine\MySpecialEngine\Scripts\ObjectClasses.h", "C++", 0, -282, 0, -27, -309
"c:\Users\gabri\OneDrive\Desktop\MySpecialEngine\MySpecialEngine\Scripts\Raycasting.h", "C++", 0, -53, 0, -19, -72
"c:\Users\gabri\OneDrive\Desktop\MySpecialEngine\MySpecialEngine\Scripts\VAOCreate.h", "C++", 0, -310, -6, -11, -327
"c:\Users\gabri\OneDrive\Desktop\MySpecialEngine\MySpecialEngine\Scripts\Vector.h", "C++", 0, -186, 0, -12, -198
"c:\Users\gabri\OneDrive\Desktop\MySpecialEngine\MySpecialEngine\Shaders\BasicFrag.frag", "GLSL", 12, 0, 0, 5, 17
"c:\Users\gabri\OneDrive\Desktop\MySpecialEngine\MySpecialEngine\Shaders\BasicVert.vert", "GLSL", 16, 0, 0, 4, 20
"c:\Users\gabri\OneDrive\Desktop\MySpecialEngine\MySpecialEngine\Shaders\FractalFrag.frag", "GLSL", 29, 0, 0, 11, 40
"c:\Users\gabri\OneDrive\Desktop\MySpecialEngine\MySpecialEngine\Shaders\FractalVert.vert", "GLSL", 6, 0, 0, 1, 7
"c:\Users\gabri\OneDrive\Desktop\MySpecialEngine\MySpecialEngine\Shaders\GenerateShadowEdges.comp", "GLSL", 118, 0, 0, 17, 135
"c:\Users\gabri\OneDrive\Desktop\MySpecialEngine\MySpecialEngine\Shaders\NoTextureFrag.frag", "GLSL", 8, 0, 0, 3, 11
"c:\Users\gabri\OneDrive\Desktop\MySpecialEngine\MySpecialEngine\Shaders\NoTextureVert.vert", "GLSL", 13, 0, 0, 4, 17
"c:\Users\gabri\OneDrive\Desktop\MySpecialEngine\MySpecialEngine\Shaders\SMappingBasicFrag.frag", "GLSL", 47, 0, 0, 11, 58
"c:\Users\gabri\OneDrive\Desktop\MySpecialEngine\MySpecialEngine\Shaders\SMappingBasicVert.vert", "GLSL", 21, 0, 0, 5, 26
"c:\Users\gabri\OneDrive\Desktop\MySpecialEngine\MySpecialEngine\Shaders\SMappingDepthTextureFrag.frag", "GLSL", 4, 0, 0, 2, 6
"c:\Users\gabri\OneDrive\Desktop\MySpecialEngine\MySpecialEngine\Shaders\SMappingDepthTextureVert.vert", "GLSL", 9, 0, 0, 2, 11
"c:\Users\gabri\OneDrive\Desktop\MySpecialEngine\MySpecialEngine\Shaders\SMappingNoTextureFrag.frag", "GLSL", 43, 0, 0, 11, 54
"c:\Users\gabri\OneDrive\Desktop\MySpecialEngine\MySpecialEngine\Shaders\SMappingNoTextureVert.vert", "GLSL", 18, 0, 0, 5, 23
"c:\Users\gabri\OneDrive\Desktop\MySpecialEngine\MySpecialEngine\Shaders\VShadowingBasicFrag.frag", "GLSL", 12, 0, 0, 5, 17
"c:\Users\gabri\OneDrive\Desktop\MySpecialEngine\MySpecialEngine\Shaders\VShadowingBasicVert.vert", "GLSL", 16, 0, 0, 4, 20
"c:\Users\gabri\OneDrive\Desktop\MySpecialEngine\MySpecialEngine\Shaders\VShadowingNoTextureFrag.frag", "GLSL", 8, 0, 0, 3, 11
"c:\Users\gabri\OneDrive\Desktop\MySpecialEngine\MySpecialEngine\Shaders\VShadowingNoTextureGeom.geom", "GLSL", 54, 0, 0, 8, 62
"c:\Users\gabri\OneDrive\Desktop\MySpecialEngine\MySpecialEngine\Shaders\VShadowingNoTextureVert.vert", "GLSL", 10, 0, 0, 3, 13
"c:\Users\gabri\OneDrive\Desktop\MySpecialEngine\MySpecialEngine\Shaders\VShadowsFrag.frag", "GLSL", 6, 0, 0, 2, 8
"c:\Users\gabri\OneDrive\Desktop\MySpecialEngine\MySpecialEngine\Shaders\VShadowsVert.vert", "GLSL", 9, 0, 0, 3, 12
"Total", "-", 459, -3326, -197, -329, -3393