"filename", "language", "GLSL", "C++", "comment", "blank", "total"
"c:\Users\gabri\OneDrive\Desktop\MySpecialEngine\MySpecialEngine\Scripts\AObjectDraw.cpp", "C++", 0, -412, -11, -71, -494
"c:\Users\gabri\OneDrive\Desktop\MySpecialEngine\MySpecialEngine\Scripts\AObjectDraw.h", "C++", 0, -68, -6, -12, -86
"c:\Users\gabri\OneDrive\Desktop\MySpecialEngine\MySpecialEngine\Scripts\ApplicationMain.cpp", "C++", 0, -302, -11, -34, -347
"c:\Users\gabri\OneDrive\Desktop\MySpecialEngine\MySpecialEngine\Scripts\ApplicationMain.h", "C++", 0, -20, 0, -5, -25
"c:\Users\gabri\OneDrive\Desktop\MySpecialEngine\MySpecialEngine\Scripts\Button.h", "C++", 0, -23, 0, -5, -28
"c:\Users\gabri\OneDrive\Desktop\MySpecialEngine\MySpecialEngine\Scripts\Camera.h", "C++", 0, -83, 0, -3, -86
"c:\Users\gabri\OneDrive\Desktop\MySpecialEngine\MySpecialEngine\Scripts\Constants.cpp", "C++", 0, 0, 0, -1, -1
"c:\Users\gabri\OneDrive\Desktop\MySpecialEngine\MySpecialEngine\Scripts\Constants.h", "C++", 0, -20, -3, -3, -26
"c:\Users\gabri\OneDrive\Desktop\MySpecialEngine\MySpecialEngine\Scripts\DrawingPad.cpp", "C++", 0, -84, -8, -9, -101
"c:\Users\gabri\OneDrive\Desktop\MySpecialEngine\MySpecialEngine\Scripts\DrawingPad.h", "C++", 0, -25, -3, -6, -34
"c:\Users\gabri\OneDrive\Desktop\MySpecialEngine\MySpecialEngine\Scripts\EngineBase.h", "C++", 0, -16, 0, -1, -17
"c:\Users\gabri\OneDrive\Desktop\MySpecialEngine\MySpecialEngine\Scripts\GUIText.cpp", "C++", 0, -249, -10, -53, -312
"c:\Users\gabri\OneDrive\Desktop\MySpecialEngine\MySpecialEngine\Scripts\GUIText.h", "C++", 0, -57, 0, -12, -69
"c:\Users\gabri\OneDrive\Desktop\MySpecialEngine\MySpecialEngine\Scripts\GlStuff.h", "C++", 0, -11, -3, -2, -16
"c:\Users\gabri\OneDrive\Desktop\MySpecialEngine\MySpecialEngine\Scripts\GlobalVars.h", "C++", 0, -32, -3, -1, -36
"c:\Users\gabri\OneDrive\Desktop\MySpecialEngine\MySpecialEngine\Scripts\IntializeShaders.h", "C++", 0, -219, -3, -22, -244
"c:\Users\gabri\OneDrive\Desktop\MySpecialEngine\MySpecialEngine\Scripts\KeyPresses.cpp", "C++", 0, -58, -3, -7, -68
"c:\Users\gabri\OneDrive\Desktop\MySpecialEngine\MySpecialEngine\Scripts\KeyPresses.h", "C++", 0, -17, -3, -4, -24
"c:\Users\gabri\OneDrive\Desktop\MySpecialEngine\MySpecialEngine\Scripts\LightingMain.cpp", "C++", 0, 0, -504, 0, -504
"c:\Users\gabri\OneDrive\Desktop\MySpecialEngine\MySpecialEngine\Scripts\LightingMain.h", "C++", 0, 0, -35, 0, -35
"c:\Users\gabri\OneDrive\Desktop\MySpecialEngine\MySpecialEngine\Scripts\List.h", "C++", 0, -192, 0, -4, -196
"c:\Users\gabri\OneDrive\Desktop\MySpecialEngine\MySpecialEngine\Scripts\MathFunctions.cpp", "C++", 0, -44, 0, -9, -53
"c:\Users\gabri\OneDrive\Desktop\MySpecialEngine\MySpecialEngine\Scripts\MathFunctions.h", "C++", 0, -15, 0, -2, -17
"c:\Users\gabri\OneDrive\Desktop\MySpecialEngine\MySpecialEngine\Scripts\ModelLoading.cpp", "C++", 0, -431, -18, -62, -511
"c:\Users\gabri\OneDrive\Desktop\MySpecialEngine\MySpecialEngine\Scripts\ModelLoading.h", "C++", 0, -87, 0, -11, -98
"c:\Users\gabri\OneDrive\Desktop\MySpecialEngine\MySpecialEngine\Scripts\Mouse.h", "C++", 0, -16, 0, -4, -20
"c:\Users\gabri\OneDrive\Desktop\MySpecialEngine\MySpecialEngine\Scripts\ObjectClasses.h", "C++", 0, -237, -61, -25, -323
"c:\Users\gabri\OneDrive\Desktop\MySpecialEngine\MySpecialEngine\Scripts\Raycasting.h", "C++", 0, -53, 0, -19, -72
"c:\Users\gabri\OneDrive\Desktop\MySpecialEngine\MySpecialEngine\Scripts\Vector.h", "C++", 0, -186, 0, -12, -198
"c:\Users\gabri\OneDrive\Desktop\MySpecialEngine\MySpecialEngine\Shaders\BasicFrag.frag", "GLSL", 8, 0, 0, 5, 13
"c:\Users\gabri\OneDrive\Desktop\MySpecialEngine\MySpecialEngine\Shaders\BasicNoTextureFrag.frag", "GLSL", 7, 0, 0, 3, 10
"c:\Users\gabri\OneDrive\Desktop\MySpecialEngine\MySpecialEngine\Shaders\BasicNoTextureVert.vert", "GLSL", 12, 0, 0, 4, 16
"c:\Users\gabri\OneDrive\Desktop\MySpecialEngine\MySpecialEngine\Shaders\BasicVert.vert", "GLSL", 16, 0, 0, 4, 20
"c:\Users\gabri\OneDrive\Desktop\MySpecialEngine\MySpecialEngine\Shaders\EShadowsFrag.frag", "GLSL", 9, 0, 0, 2, 11
"c:\Users\gabri\OneDrive\Desktop\MySpecialEngine\MySpecialEngine\Shaders\EShadowsVert.vert", "GLSL", 9, 0, 0, 2, 11
"c:\Users\gabri\OneDrive\Desktop\MySpecialEngine\MySpecialEngine\Shaders\FractalFrag.frag", "GLSL", 29, 0, 0, 11, 40
"c:\Users\gabri\OneDrive\Desktop\MySpecialEngine\MySpecialEngine\Shaders\FractalVert.vert", "GLSL", 6, 0, 0, 1, 7
"c:\Users\gabri\OneDrive\Desktop\MySpecialEngine\MySpecialEngine\Shaders\GenerateShadowEdges.comp", "GLSL", 112, 0, 0, 18, 130
"c:\Users\gabri\OneDrive\Desktop\MySpecialEngine\MySpecialEngine\Shaders\SMappingBasicFrag.frag", "GLSL", 47, 0, 0, 11, 58
"c:\Users\gabri\OneDrive\Desktop\MySpecialEngine\MySpecialEngine\Shaders\SMappingBasicVert.vert", "GLSL", 21, 0, 0, 5, 26
"c:\Users\gabri\OneDrive\Desktop\MySpecialEngine\MySpecialEngine\Shaders\SMappingDepthTextureFrag.frag", "GLSL", 4, 0, 0, 2, 6
"c:\Users\gabri\OneDrive\Desktop\MySpecialEngine\MySpecialEngine\Shaders\SMappingDepthTextureVert.vert", "GLSL", 9, 0, 0, 2, 11
"c:\Users\gabri\OneDrive\Desktop\MySpecialEngine\MySpecialEngine\Shaders\SMappingNoTextureFrag.frag", "GLSL", 43, 0, 0, 11, 54
"c:\Users\gabri\OneDrive\Desktop\MySpecialEngine\MySpecialEngine\Shaders\SMappingNoTextureVert.vert", "GLSL", 18, 0, 0, 5, 23
"c:\Users\gabri\OneDrive\Desktop\MySpecialEngine\MySpecialEngine\Shaders\SSDarkenFrag.frag", "GLSL", 6, 0, 0, 2, 8
"c:\Users\gabri\OneDrive\Desktop\MySpecialEngine\MySpecialEngine\Shaders\SSDarkenVert.vert", "GLSL", 9, 0, 0, 2, 11
"c:\Users\gabri\OneDrive\Desktop\MySpecialEngine\MySpecialEngine\Shaders\SShadowingBasicFrag.frag", "GLSL", 12, 0, 0, 5, 17
"c:\Users\gabri\OneDrive\Desktop\MySpecialEngine\MySpecialEngine\Shaders\SShadowingBasicVert.vert", "GLSL", 16, 0, 0, 4, 20
"c:\Users\gabri\OneDrive\Desktop\MySpecialEngine\MySpecialEngine\Shaders\SShadowingNoTextureFrag.frag", "GLSL", 18, 0, 0, 5, 23
"c:\Users\gabri\OneDrive\Desktop\MySpecialEngine\MySpecialEngine\Shaders\SShadowingNoTextureGeom.geom", "GLSL", 54, 0, 0, 8, 62
"c:\Users\gabri\OneDrive\Desktop\MySpecialEngine\MySpecialEngine\Shaders\SShadowingNoTextureVert.vert", "GLSL", 10, 0, 0, 3, 13
"c:\Users\gabri\OneDrive\Desktop\MySpecialEngine\MySpecialEngine\Shaders\SShadowsFrag.frag", "GLSL", 7, 0, 0, 3, 10
"c:\Users\gabri\OneDrive\Desktop\MySpecialEngine\MySpecialEngine\Shaders\SShadowsGeom.geom", "GLSL", 64, 0, 0, 10, 74
"c:\Users\gabri\OneDrive\Desktop\MySpecialEngine\MySpecialEngine\Shaders\SShadowsVert.vert", "GLSL", 22, 0, 0, 4, 26
"c:\Users\gabri\OneDrive\Desktop\MySpecialEngine\MySpecialEngine\Shaders\WhiteSpaceFrag.frag", "GLSL", 6, 0, 0, 2, 8
"c:\Users\gabri\OneDrive\Desktop\MySpecialEngine\MySpecialEngine\Shaders\WhiteSpaceVert.vert", "GLSL", 9, 0, 0, 2, 11
"Total", "-", 583, -2957, -685, -263, -3322