"filename", "language", "C++", "comment", "blank", "total"
"c:\Users\gabri\OneDrive\Desktop\Coding\MySpecialEngine\CPPEngine\Scripts\AObjectDraw.cpp", "C++", 414, 27, 74, 515
"c:\Users\gabri\OneDrive\Desktop\Coding\MySpecialEngine\CPPEngine\Scripts\AObjectDraw.h", "C++", 38, 3, 6, 47
"c:\Users\gabri\OneDrive\Desktop\Coding\MySpecialEngine\CPPEngine\Scripts\ApplicationGUI.cpp", "C++", 43, 0, 9, 52
"c:\Users\gabri\OneDrive\Desktop\Coding\MySpecialEngine\CPPEngine\Scripts\ApplicationGUI.h", "C++", 15, 0, 5, 20
"c:\Users\gabri\OneDrive\Desktop\Coding\MySpecialEngine\CPPEngine\Scripts\ApplicationMain.cpp", "C++", 320, 9, 42, 371
"c:\Users\gabri\OneDrive\Desktop\Coding\MySpecialEngine\CPPEngine\Scripts\ApplicationMain.h", "C++", 24, 0, 7, 31
"c:\Users\gabri\OneDrive\Desktop\Coding\MySpecialEngine\CPPEngine\Scripts\Button.h", "C++", 74, 0, 12, 86
"c:\Users\gabri\OneDrive\Desktop\Coding\MySpecialEngine\CPPEngine\Scripts\Camera.cpp", "C++", 28, 8, 2, 38
"c:\Users\gabri\OneDrive\Desktop\Coding\MySpecialEngine\CPPEngine\Scripts\Camera.h", "C++", 133, 0, 20, 153
"c:\Users\gabri\OneDrive\Desktop\Coding\MySpecialEngine\CPPEngine\Scripts\Constants.h", "C++", 21, 3, 3, 27
"c:\Users\gabri\OneDrive\Desktop\Coding\MySpecialEngine\CPPEngine\Scripts\DLLmain.h", "C++", 11, 0, 3, 14
"c:\Users\gabri\OneDrive\Desktop\Coding\MySpecialEngine\CPPEngine\Scripts\Dllmain.cpp", "C++", 16, 0, 1, 17
"c:\Users\gabri\OneDrive\Desktop\Coding\MySpecialEngine\CPPEngine\Scripts\DrawingPad.cpp", "C++", 115, 5, 20, 140
"c:\Users\gabri\OneDrive\Desktop\Coding\MySpecialEngine\CPPEngine\Scripts\DrawingPad.h", "C++", 25, 3, 6, 34
"c:\Users\gabri\OneDrive\Desktop\Coding\MySpecialEngine\CPPEngine\Scripts\EngineBase.h", "C++", 16, 0, 1, 17
"c:\Users\gabri\OneDrive\Desktop\Coding\MySpecialEngine\CPPEngine\Scripts\GUIText.cpp", "C++", 320, 1, 102, 423
"c:\Users\gabri\OneDrive\Desktop\Coding\MySpecialEngine\CPPEngine\Scripts\GUIText.h", "C++", 72, 0, 13, 85
"c:\Users\gabri\OneDrive\Desktop\Coding\MySpecialEngine\CPPEngine\Scripts\GlStuff.h", "C++", 10, 3, 2, 15
"c:\Users\gabri\OneDrive\Desktop\Coding\MySpecialEngine\CPPEngine\Scripts\GlobalVars.h", "C++", 32, 3, 1, 36
"c:\Users\gabri\OneDrive\Desktop\Coding\MySpecialEngine\CPPEngine\Scripts\IntializeShaders.h", "C++", 225, 3, 22, 250
"c:\Users\gabri\OneDrive\Desktop\Coding\MySpecialEngine\CPPEngine\Scripts\KeyPresses.cpp", "C++", 53, 3, 6, 62
"c:\Users\gabri\OneDrive\Desktop\Coding\MySpecialEngine\CPPEngine\Scripts\KeyPresses.h", "C++", 24, 3, 3, 30
"c:\Users\gabri\OneDrive\Desktop\Coding\MySpecialEngine\CPPEngine\Scripts\List.h", "C++", 145, 0, 4, 149
"c:\Users\gabri\OneDrive\Desktop\Coding\MySpecialEngine\CPPEngine\Scripts\ListFolder.cpp", "C++", 62, 0, 10, 72
"c:\Users\gabri\OneDrive\Desktop\Coding\MySpecialEngine\CPPEngine\Scripts\ListFolder.h", "C++", 16, 0, 6, 22
"c:\Users\gabri\OneDrive\Desktop\Coding\MySpecialEngine\CPPEngine\Scripts\MathFunctions.cpp", "C++", 42, 0, 9, 51
"c:\Users\gabri\OneDrive\Desktop\Coding\MySpecialEngine\CPPEngine\Scripts\MathFunctions.h", "C++", 15, 0, 2, 17
"c:\Users\gabri\OneDrive\Desktop\Coding\MySpecialEngine\CPPEngine\Scripts\ModelLoading.cpp", "C++", 310, 9, 47, 366
"c:\Users\gabri\OneDrive\Desktop\Coding\MySpecialEngine\CPPEngine\Scripts\ModelLoading.h", "C++", 75, 0, 10, 85
"c:\Users\gabri\OneDrive\Desktop\Coding\MySpecialEngine\CPPEngine\Scripts\Mouse.h", "C++", 16, 0, 4, 20
"c:\Users\gabri\OneDrive\Desktop\Coding\MySpecialEngine\CPPEngine\Scripts\ObjectClasses.h", "C++", 409, 2, 34, 445
"c:\Users\gabri\OneDrive\Desktop\Coding\MySpecialEngine\CPPEngine\Scripts\Vector.h", "C++", 295, 0, 13, 308
"c:\Users\gabri\OneDrive\Desktop\Coding\MySpecialEngine\CPPEngine\Scripts\pch.h", "C++", 4, 0, 2, 6
"Total", "-", 3418, 85, 501, 4004